"","1","2","3","NA","Alcohol_Related_N","Alcohol_Related_Y","DV_Related_N","DV_Related_Y","Assaults"
"2006/1/1",11,57,0,106,71,103,108,66,174
"2006/1/10",4,20,0,41,48,17,44,21,65
"2006/1/11",2,21,0,56,53,26,40,39,79
"2006/1/12",10,18,0,51,52,27,52,27,79
"2006/1/13",7,24,0,60,62,29,46,45,91
"2006/1/14",16,46,0,98,70,90,110,50,160
"2006/1/15",8,38,0,64,63,47,65,45,110
"2006/1/16",4,19,0,59,62,20,59,23,82
"2006/1/17",8,23,0,53,59,25,44,40,84
"2006/1/18",4,22,0,36,49,13,32,30,62
"2006/1/19",2,22,0,55,53,26,53,26,79
"2006/1/2",1,30,1,38,52,18,32,38,70
"2006/1/20",9,43,0,38,56,34,55,35,90
"2006/1/21",7,45,1,62,52,63,73,42,115
"2006/1/22",4,45,0,84,55,78,76,57,133
"2006/1/23",7,27,0,50,56,28,42,42,84
"2006/1/24",3,27,0,40,55,15,38,32,70
"2006/1/25",5,24,0,45,48,26,41,33,74
"2006/1/26",5,50,0,90,69,76,98,47,145
"2006/1/27",7,39,0,80,73,53,84,42,126
"2006/1/28",6,23,1,82,56,56,72,40,112
"2006/1/29",6,24,0,78,66,42,60,48,108
"2006/1/3",5,28,0,56,69,20,47,42,89
"2006/1/30",6,25,0,50,55,26,35,46,81
"2006/1/31",5,23,1,52,58,23,46,35,81
"2006/1/4",3,21,0,37,48,13,40,21,61
"2006/1/5",2,12,0,33,33,14,33,14,47
"2006/1/6",5,19,1,40,47,18,35,30,65
"2006/1/7",4,32,0,59,45,50,52,43,95
"2006/1/8",6,48,1,53,47,61,64,44,108
"2006/1/9",6,23,0,43,54,18,34,38,72
"2006/10/1",11,46,0,52,51,58,63,46,109
"2006/10/10",3,17,0,33,41,12,31,22,53
"2006/10/11",7,18,0,44,59,10,43,26,69
"2006/10/12",4,20,0,47,48,23,37,34,71
"2006/10/13",9,24,0,57,53,37,60,30,90
"2006/10/14",5,34,0,78,56,61,78,39,117
"2006/10/15",13,46,0,49,55,53,57,51,108
"2006/10/16",2,27,0,45,69,5,44,30,74
"2006/10/17",7,18,0,48,61,12,49,24,73
"2006/10/18",7,30,0,36,51,22,37,36,73
"2006/10/19",6,25,0,50,52,29,51,30,81
"2006/10/2",9,17,0,43,46,23,39,30,69
"2006/10/20",10,19,1,67,73,24,61,36,97
"2006/10/21",6,32,1,66,46,59,77,28,105
"2006/10/22",4,34,0,73,53,58,68,43,111
"2006/10/23",2,28,0,48,54,24,48,30,78
"2006/10/24",3,27,0,50,64,16,57,23,80
"2006/10/25",4,23,0,68,78,17,55,40,95
"2006/10/26",9,23,1,50,62,21,55,28,83
"2006/10/27",8,33,0,63,67,37,66,38,104
"2006/10/28",5,47,0,73,67,58,80,45,125
"2006/10/29",5,20,0,62,42,45,55,32,87
"2006/10/3",2,30,2,46,69,11,46,34,80
"2006/10/30",15,25,0,48,68,20,55,33,88
"2006/10/31",3,33,0,65,89,12,72,29,101
"2006/10/4",5,38,1,49,65,28,53,40,93
"2006/10/5",1,23,0,63,59,28,56,31,87
"2006/10/6",3,27,0,74,65,39,75,29,104
"2006/10/7",5,41,1,86,73,60,91,42,133
"2006/10/8",6,31,2,63,57,45,65,37,102
"2006/10/9",1,29,0,48,62,16,54,24,78
"2006/11/1",3,33,0,60,75,21,55,41,96
"2006/11/10",8,23,0,59,58,32,61,29,90
"2006/11/11",14,32,2,73,59,62,84,37,121
"2006/11/12",3,31,0,78,64,48,77,35,112
"2006/11/13",6,30,4,59,86,13,51,48,99
"2006/11/14",2,20,0,44,48,18,49,17,66
"2006/11/15",2,28,1,45,58,18,48,28,76
"2006/11/16",5,27,0,52,67,17,56,28,84
"2006/11/17",3,30,0,65,68,30,63,35,98
"2006/11/18",4,33,1,67,46,59,70,35,105
"2006/11/19",7,34,1,79,68,53,76,45,121
"2006/11/2",5,33,0,55,76,17,47,46,93
"2006/11/20",4,18,0,46,52,16,43,25,68
"2006/11/21",5,31,1,54,61,30,64,27,91
"2006/11/22",6,14,1,36,40,17,35,22,57
"2006/11/23",8,32,0,39,45,34,49,30,79
"2006/11/24",10,33,0,51,69,25,64,30,94
"2006/11/25",8,47,0,86,71,70,97,44,141
"2006/11/26",7,38,0,58,56,47,71,32,103
"2006/11/27",4,35,0,60,80,19,65,34,99
"2006/11/28",7,29,1,53,66,24,53,37,90
"2006/11/29",1,29,0,51,52,29,51,30,81
"2006/11/3",7,17,0,53,55,22,47,30,77
"2006/11/30",7,33,0,56,59,37,60,36,96
"2006/11/4",5,38,0,74,63,54,76,41,117
"2006/11/5",6,27,0,56,39,50,57,32,89
"2006/11/6",2,23,1,56,69,13,50,32,82
"2006/11/7",6,32,0,70,59,49,81,27,108
"2006/11/8",3,33,0,49,59,26,54,31,85
"2006/11/9",9,30,1,51,65,26,67,24,91
"2006/12/1",8,38,0,76,73,49,88,34,122
"2006/12/10",12,40,0,72,59,65,75,49,124
"2006/12/11",7,25,0,55,65,22,62,25,87
"2006/12/12",7,19,0,38,48,16,45,19,64
"2006/12/13",7,31,0,53,67,24,57,34,91
"2006/12/14",3,22,0,62,50,37,59,28,87
"2006/12/15",3,44,0,56,65,38,72,31,103
"2006/12/16",9,24,2,96,59,72,86,45,131
"2006/12/17",13,38,1,76,75,53,71,57,128
"2006/12/18",7,35,0,45,55,32,45,42,87
"2006/12/19",4,47,1,54,82,24,63,43,106
"2006/12/2",5,25,0,64,51,43,63,31,94
"2006/12/20",11,29,0,43,60,23,49,34,83
"2006/12/21",5,25,1,65,51,45,67,29,96
"2006/12/22",7,34,0,73,60,54,76,38,114
"2006/12/23",9,27,2,70,55,53,76,32,108
"2006/12/24",6,31,1,62,40,60,72,28,100
"2006/12/25",2,35,0,48,36,49,40,45,85
"2006/12/26",4,21,0,44,37,32,42,27,69
"2006/12/27",6,25,1,42,36,38,40,34,74
"2006/12/28",5,27,0,45,49,28,41,36,77
"2006/12/29",3,25,0,46,50,24,48,26,74
"2006/12/3",23,24,0,75,61,61,71,51,122
"2006/12/30",7,32,0,65,55,49,57,47,104
"2006/12/31",13,21,0,70,44,60,64,40,104
"2006/12/4",6,27,1,61,67,28,59,36,95
"2006/12/5",5,29,0,48,66,16,43,39,82
"2006/12/6",13,20,0,54,63,24,57,30,87
"2006/12/7",8,25,0,61,60,34,58,36,94
"2006/12/8",12,42,0,64,72,46,71,47,118
"2006/12/9",7,47,0,67,59,62,81,40,121
"2006/2/1",5,12,0,56,59,14,43,30,73
"2006/2/10",11,22,0,65,71,27,68,30,98
"2006/2/11",3,30,0,74,60,47,70,37,107
"2006/2/12",7,30,0,91,67,61,87,41,128
"2006/2/13",10,16,0,53,61,18,48,31,79
"2006/2/14",7,31,0,51,68,21,59,30,89
"2006/2/15",1,28,0,58,69,18,54,33,87
"2006/2/16",2,24,0,54,59,21,54,26,80
"2006/2/17",9,33,0,58,61,39,59,41,100
"2006/2/18",8,44,0,89,68,73,97,44,141
"2006/2/19",11,55,2,74,81,61,85,57,142
"2006/2/2",4,36,0,49,61,28,52,37,89
"2006/2/20",4,25,1,58,68,20,47,41,88
"2006/2/21",4,32,1,40,62,15,47,30,77
"2006/2/22",5,49,1,53,83,25,67,41,108
"2006/2/23",6,36,0,62,83,21,67,37,104
"2006/2/24",7,27,0,62,60,36,67,29,96
"2006/2/25",9,42,0,106,88,69,99,58,157
"2006/2/26",7,40,0,81,62,66,84,44,128
"2006/2/27",7,27,0,61,71,24,57,38,95
"2006/2/28",9,25,1,58,67,26,52,41,93
"2006/2/3",16,26,0,63,70,35,70,35,105
"2006/2/4",8,41,0,76,66,59,86,39,125
"2006/2/5",8,38,0,83,64,65,74,55,129
"2006/2/6",13,26,1,51,63,28,46,45,91
"2006/2/7",9,14,0,64,67,20,52,35,87
"2006/2/8",8,21,0,43,49,23,43,29,72
"2006/2/9",4,22,0,63,61,28,70,19,89
"2006/3/1",3,18,0,57,60,18,48,30,78
"2006/3/10",8,23,1,59,46,45,53,38,91
"2006/3/11",10,46,0,75,56,75,93,38,131
"2006/3/12",7,40,0,82,66,63,81,48,129
"2006/3/13",3,24,0,52,68,11,48,31,79
"2006/3/14",5,22,0,58,63,22,52,33,85
"2006/3/15",6,17,0,50,54,19,43,30,73
"2006/3/16",7,23,0,51,57,24,57,24,81
"2006/3/17",12,28,0,41,42,39,44,37,81
"2006/3/18",4,38,0,84,58,68,87,39,126
"2006/3/19",5,47,0,75,70,57,81,46,127
"2006/3/2",2,24,0,49,51,24,54,21,75
"2006/3/20",5,21,0,56,57,25,52,30,82
"2006/3/21",6,20,0,41,54,13,37,30,67
"2006/3/22",7,25,0,60,56,36,67,25,92
"2006/3/23",5,31,0,49,58,27,49,36,85
"2006/3/24",9,39,0,55,50,53,58,45,103
"2006/3/25",5,37,0,88,55,75,78,52,130
"2006/3/26",5,51,1,66,53,70,79,44,123
"2006/3/27",5,23,1,56,61,24,47,38,85
"2006/3/28",12,28,0,56,69,27,54,42,96
"2006/3/29",7,32,0,42,64,17,52,29,81
"2006/3/3",3,27,0,55,56,29,62,23,85
"2006/3/30",10,27,0,52,59,30,50,39,89
"2006/3/31",1,27,0,54,54,28,65,17,82
"2006/3/4",7,58,0,90,81,74,100,55,155
"2006/3/5",15,50,0,85,83,67,92,58,150
"2006/3/6",3,24,0,70,78,19,60,37,97
"2006/3/7",1,22,0,44,51,16,49,18,67
"2006/3/8",10,19,0,55,71,13,56,28,84
"2006/3/9",9,36,0,39,53,31,51,33,84
"2006/4/1",10,46,0,76,52,80,95,37,132
"2006/4/10",6,16,0,36,46,12,36,22,58
"2006/4/11",4,22,1,61,71,17,64,24,88
"2006/4/12",10,19,0,54,66,17,45,38,83
"2006/4/13",5,29,0,61,59,36,64,31,95
"2006/4/14",7,35,0,76,54,64,81,37,118
"2006/4/15",8,22,0,53,46,37,55,28,83
"2006/4/16",9,34,1,68,47,65,67,45,112
"2006/4/17",4,20,0,48,40,32,43,29,72
"2006/4/18",8,19,0,55,60,22,49,33,82
"2006/4/19",4,20,0,50,51,23,46,28,74
"2006/4/2",4,27,0,49,46,34,42,38,80
"2006/4/20",3,20,0,41,41,23,41,23,64
"2006/4/21",7,24,0,59,59,31,59,31,90
"2006/4/22",13,31,0,69,62,51,72,41,113
"2006/4/23",4,23,0,67,46,48,61,33,94
"2006/4/24",8,20,0,31,36,23,26,33,59
"2006/4/25",6,24,1,82,45,68,72,41,113
"2006/4/26",5,22,0,41,48,20,48,20,68
"2006/4/27",7,26,0,40,58,15,42,31,73
"2006/4/28",3,18,0,50,47,24,53,18,71
"2006/4/29",1,30,0,53,38,46,52,32,84
"2006/4/3",4,27,1,49,56,25,51,30,81
"2006/4/30",7,26,0,64,51,46,67,30,97
"2006/4/4",9,13,1,52,63,12,41,34,75
"2006/4/5",4,32,1,55,67,25,56,36,92
"2006/4/6",4,23,0,47,59,15,57,17,74
"2006/4/7",2,35,0,60,61,36,67,30,97
"2006/4/8",4,29,0,67,53,47,70,30,100
"2006/4/9",7,36,0,61,59,45,70,34,104
"2006/5/1",4,28,0,50,60,22,45,37,82
"2006/5/10",7,36,0,47,65,25,44,46,90
"2006/5/11",3,20,0,33,38,18,39,17,56
"2006/5/12",5,24,0,52,53,28,65,16,81
"2006/5/13",7,19,0,52,39,39,50,28,78
"2006/5/14",7,27,0,61,48,47,51,44,95
"2006/5/15",4,7,0,37,40,8,27,21,48
"2006/5/16",11,22,0,36,57,12,43,26,69
"2006/5/17",7,22,0,60,55,34,65,24,89
"2006/5/18",6,16,0,68,48,42,72,18,90
"2006/5/19",10,28,0,63,60,41,68,33,101
"2006/5/2",2,20,0,41,53,10,36,27,63
"2006/5/20",8,39,0,50,43,54,63,34,97
"2006/5/21",5,33,0,61,48,51,64,35,99
"2006/5/22",1,22,0,47,57,13,35,35,70
"2006/5/23",5,21,0,36,48,14,40,22,62
"2006/5/24",6,19,1,38,38,26,42,22,64
"2006/5/25",7,20,0,46,51,22,56,17,73
"2006/5/26",2,29,0,49,55,25,43,37,80
"2006/5/27",8,21,1,76,49,57,77,29,106
"2006/5/28",12,32,1,55,47,53,58,42,100
"2006/5/29",5,18,0,33,45,11,31,25,56
"2006/5/3",5,30,0,42,61,16,47,30,77
"2006/5/30",1,15,0,30,40,6,30,16,46
"2006/5/31",4,16,0,50,55,15,40,30,70
"2006/5/4",7,17,0,50,55,19,48,26,74
"2006/5/5",6,15,0,52,49,24,51,22,73
"2006/5/6",10,31,0,58,50,49,65,34,99
"2006/5/7",7,19,0,64,50,40,51,39,90
"2006/5/8",3,13,1,36,42,11,31,22,53
"2006/5/9",2,18,0,37,47,10,35,22,57
"2006/6/1",6,25,0,35,51,15,33,33,66
"2006/6/10",6,34,0,56,54,42,60,36,96
"2006/6/11",2,21,0,66,37,52,58,31,89
"2006/6/12",2,28,1,39,46,24,30,40,70
"2006/6/13",2,19,1,41,49,14,38,25,63
"2006/6/14",6,21,0,50,60,17,39,38,77
"2006/6/15",7,18,0,51,56,20,46,30,76
"2006/6/16",9,30,2,39,59,21,51,29,80
"2006/6/17",7,36,0,55,45,53,62,36,98
"2006/6/18",7,24,0,62,59,34,63,30,93
"2006/6/19",6,18,0,43,51,16,44,23,67
"2006/6/2",4,25,0,51,47,33,51,29,80
"2006/6/20",2,19,0,39,50,10,41,19,60
"2006/6/21",3,15,0,49,49,18,46,21,67
"2006/6/22",9,14,0,41,42,22,37,27,64
"2006/6/23",8,22,1,49,51,29,49,31,80
"2006/6/24",2,24,1,54,44,37,59,22,81
"2006/6/25",3,35,0,64,54,48,62,40,102
"2006/6/26",3,26,0,41,62,8,39,31,70
"2006/6/27",4,20,0,43,44,23,44,23,67
"2006/6/28",8,23,1,49,69,12,46,35,81
"2006/6/29",6,14,0,42,49,13,36,26,62
"2006/6/3",9,28,0,78,67,48,78,37,115
"2006/6/30",5,23,0,45,44,29,50,23,73
"2006/6/4",4,32,1,75,64,48,63,49,112
"2006/6/5",9,21,1,40,57,14,43,28,71
"2006/6/6",5,23,0,37,54,11,37,28,65
"2006/6/7",6,16,0,34,44,12,34,22,56
"2006/6/8",7,16,0,49,56,16,51,21,72
"2006/6/9",4,12,0,51,43,24,46,21,67
"2006/7/1",11,31,1,56,62,37,69,30,99
"2006/7/10",9,16,0,25,33,17,30,20,50
"2006/7/11",7,29,0,51,69,18,43,44,87
"2006/7/12",7,17,0,39,49,14,40,23,63
"2006/7/13",4,13,1,59,55,22,48,29,77
"2006/7/14",4,20,0,53,49,28,53,24,77
"2006/7/15",6,37,0,73,45,71,83,33,116
"2006/7/16",15,24,0,74,60,53,75,38,113
"2006/7/17",7,25,0,48,59,21,55,25,80
"2006/7/18",1,17,0,28,34,12,21,25,46
"2006/7/19",8,13,0,33,34,20,36,18,54
"2006/7/2",10,21,0,76,55,52,70,37,107
"2006/7/20",4,30,0,42,57,19,48,28,76
"2006/7/21",7,16,5,63,63,28,63,28,91
"2006/7/22",8,29,0,66,54,49,73,30,103
"2006/7/23",9,32,1,67,61,48,63,46,109
"2006/7/24",3,17,0,42,49,13,44,18,62
"2006/7/25",4,17,0,55,63,13,45,31,76
"2006/7/26",4,17,0,47,49,19,52,16,68
"2006/7/27",10,12,0,52,52,22,54,20,74
"2006/7/28",8,21,0,55,58,26,62,22,84
"2006/7/29",12,24,0,76,46,66,85,27,112
"2006/7/3",3,14,0,33,41,9,31,19,50
"2006/7/30",7,31,0,67,54,51,70,35,105
"2006/7/31",4,25,0,42,54,17,44,27,71
"2006/7/4",3,23,1,41,52,16,47,21,68
"2006/7/5",14,14,0,38,52,14,40,26,66
"2006/7/6",6,16,0,48,48,22,50,20,70
"2006/7/7",0,24,1,44,42,27,41,28,69
"2006/7/8",12,33,1,73,75,44,73,46,119
"2006/7/9",10,43,0,67,57,63,70,50,120
"2006/8/1",2,20,0,34,44,12,31,25,56
"2006/8/10",5,23,0,47,59,16,52,23,75
"2006/8/11",3,20,0,63,56,30,63,23,86
"2006/8/12",4,33,0,71,52,56,76,32,108
"2006/8/13",2,28,1,67,60,38,63,35,98
"2006/8/14",4,15,0,41,45,15,37,23,60
"2006/8/15",5,25,0,53,68,15,49,34,83
"2006/8/16",1,13,0,43,47,10,41,16,57
"2006/8/17",2,26,3,54,63,22,57,28,85
"2006/8/18",9,20,0,53,48,34,66,16,82
"2006/8/19",4,31,0,61,47,49,65,31,96
"2006/8/2",4,18,0,41,48,15,44,19,63
"2006/8/20",6,29,1,63,55,44,63,36,99
"2006/8/21",9,17,0,43,56,13,45,24,69
"2006/8/22",9,18,0,52,66,13,47,32,79
"2006/8/23",7,13,0,51,57,14,39,32,71
"2006/8/24",4,22,0,40,46,20,42,24,66
"2006/8/25",11,18,0,56,52,33,56,29,85
"2006/8/26",11,27,0,53,50,41,62,29,91
"2006/8/27",6,20,0,60,47,39,58,28,86
"2006/8/28",7,23,1,37,50,18,43,25,68
"2006/8/29",6,24,1,44,60,15,47,28,75
"2006/8/3",7,16,0,35,44,14,39,19,58
"2006/8/30",4,23,0,41,49,19,47,21,68
"2006/8/31",3,23,0,56,56,26,53,29,82
"2006/8/4",7,33,0,49,64,25,51,38,89
"2006/8/5",2,29,0,87,56,62,78,40,118
"2006/8/6",10,32,0,54,51,45,48,48,96
"2006/8/7",6,13,0,44,50,13,36,27,63
"2006/8/8",3,20,0,52,59,16,53,22,75
"2006/8/9",1,19,0,56,54,22,54,22,76
"2006/9/1",6,26,0,69,72,29,66,35,101
"2006/9/10",3,29,0,44,38,38,45,31,76
"2006/9/11",1,23,1,39,49,15,37,27,64
"2006/9/12",3,15,0,48,52,14,40,26,66
"2006/9/13",7,24,0,37,48,20,46,22,68
"2006/9/14",3,21,0,58,63,19,56,26,82
"2006/9/15",3,32,1,64,56,44,68,32,100
"2006/9/16",10,32,0,59,52,49,71,30,101
"2006/9/17",14,29,0,73,46,70,84,32,116
"2006/9/18",11,20,0,46,62,15,38,39,77
"2006/9/19",8,21,0,46,63,12,49,26,75
"2006/9/2",10,22,1,90,65,58,91,32,123
"2006/9/20",10,15,0,61,72,14,60,26,86
"2006/9/21",16,25,0,57,64,34,67,31,98
"2006/9/22",7,26,0,49,51,31,52,30,82
"2006/9/23",13,26,0,73,62,50,76,36,112
"2006/9/24",11,41,1,63,51,65,65,51,116
"2006/9/25",5,23,0,42,57,13,39,31,70
"2006/9/26",3,15,0,56,64,10,42,32,74
"2006/9/27",2,26,1,42,55,16,39,32,71
"2006/9/28",0,37,2,46,60,25,62,23,85
"2006/9/29",7,23,3,44,44,33,52,25,77
"2006/9/3",3,31,2,93,62,67,86,43,129
"2006/9/30",5,25,0,58,46,42,64,24,88
"2006/9/4",2,16,0,50,57,11,50,18,68
"2006/9/5",7,28,0,50,73,12,47,38,85
"2006/9/6",7,21,0,46,55,19,43,31,74
"2006/9/7",5,20,0,47,58,14,44,28,72
"2006/9/8",0,4,0,14,13,5,13,5,18
"2007/1/13",3,20,0,42,33,32,41,24,65
"2007/1/14",11,32,0,67,51,59,64,46,110
"2007/1/15",9,26,0,43,56,22,43,35,78
"2007/1/16",7,18,0,38,43,20,36,27,63
"2007/1/17",5,18,0,41,49,15,39,25,64
"2007/1/18",12,26,1,48,54,33,52,35,87
"2007/1/19",8,27,1,48,50,34,46,38,84
"2007/1/2",9,31,0,59,73,26,46,53,99
"2007/1/20",12,32,0,67,55,56,65,46,111
"2007/1/21",10,28,0,58,55,41,61,35,96
"2007/1/22",6,27,0,70,82,21,54,49,103
"2007/1/23",5,22,0,42,54,15,42,27,69
"2007/1/24",5,36,0,40,53,28,38,43,81
"2007/1/25",3,27,0,50,45,35,55,25,80
"2007/1/26",8,52,0,89,64,85,106,43,149
"2007/1/27",11,27,0,79,52,65,76,41,117
"2007/1/28",3,34,1,67,60,45,63,42,105
"2007/1/29",3,26,0,60,64,25,50,39,89
"2007/1/3",10,28,0,43,52,29,44,37,81
"2007/1/30",10,36,0,43,66,23,45,44,89
"2007/1/31",3,40,0,48,69,22,51,40,91
"2007/1/4",11,22,2,44,49,30,40,39,79
"2007/1/5",10,36,0,56,62,40,63,39,102
"2007/1/6",5,27,1,48,51,30,44,37,81
"2007/1/7",10,46,0,54,51,59,57,53,110
"2007/1/8",7,26,0,34,52,15,35,32,67
"2007/1/9",8,22,1,36,42,25,36,31,67
"2007/10/1",3,41,0,62,60,46,63,43,106
"2007/10/10",7,8,0,48,50,13,44,19,63
"2007/10/11",1,25,0,43,52,17,39,30,69
"2007/10/12",12,23,0,58,48,45,64,29,93
"2007/10/13",2,29,0,71,59,43,67,35,102
"2007/10/14",3,34,0,77,42,72,75,39,114
"2007/10/15",3,19,0,48,56,14,46,24,70
"2007/10/16",5,21,0,47,50,23,45,28,73
"2007/10/17",3,16,0,45,54,10,46,18,64
"2007/10/18",5,18,1,43,52,15,52,15,67
"2007/10/19",4,32,0,47,44,39,50,33,83
"2007/10/2",1,17,0,55,60,13,42,31,73
"2007/10/20",4,8,0,17,13,16,16,13,29
"2007/10/25",1,1,0,2,4,0,3,1,4
"2007/10/26",8,25,0,53,45,41,58,28,86
"2007/10/27",15,26,0,81,49,73,82,40,122
"2007/10/28",17,25,0,85,64,63,86,41,127
"2007/10/29",10,23,0,51,59,25,50,34,84
"2007/10/3",4,20,0,52,59,17,47,29,76
"2007/10/30",6,27,0,47,64,16,45,35,80
"2007/10/31",11,36,0,45,70,22,54,38,92
"2007/10/4",4,19,0,54,43,34,47,30,77
"2007/10/5",4,39,0,59,63,39,68,34,102
"2007/10/6",19,38,0,69,48,78,92,34,126
"2007/10/7",10,33,0,73,60,56,76,40,116
"2007/10/8",4,10,0,39,42,11,27,26,53
"2007/10/9",4,16,0,43,49,14,41,22,63
"2007/11/1",10,33,1,64,84,24,65,43,108
"2007/11/10",12,30,0,95,69,68,86,51,137
"2007/11/11",6,47,1,92,68,78,93,53,146
"2007/11/12",6,24,0,38,48,20,40,28,68
"2007/11/13",7,24,1,45,58,19,52,25,77
"2007/11/14",9,24,0,43,54,22,49,27,76
"2007/11/15",5,28,0,52,65,20,56,29,85
"2007/11/16",11,37,0,67,63,52,75,40,115
"2007/11/17",17,28,0,87,58,74,90,42,132
"2007/11/18",5,50,1,101,83,74,114,43,157
"2007/11/19",7,23,0,46,54,22,45,31,76
"2007/11/2",10,31,0,59,60,40,72,28,100
"2007/11/20",2,23,0,45,56,14,42,28,70
"2007/11/21",2,22,0,66,69,21,54,36,90
"2007/11/22",6,15,0,57,58,20,62,16,78
"2007/11/23",4,24,0,78,67,39,78,28,106
"2007/11/24",3,17,0,86,55,51,81,25,106
"2007/11/25",4,36,0,80,63,57,81,39,120
"2007/11/26",3,28,0,60,69,22,51,40,91
"2007/11/27",6,22,1,41,56,14,38,32,70
"2007/11/28",10,27,0,43,57,23,53,27,80
"2007/11/29",8,27,0,53,66,22,56,32,88
"2007/11/3",4,40,1,79,65,59,85,39,124
"2007/11/30",6,27,0,57,59,31,64,26,90
"2007/11/4",6,42,0,82,74,56,68,62,130
"2007/11/5",4,21,0,53,61,17,37,41,78
"2007/11/6",4,41,1,59,47,58,65,40,105
"2007/11/7",6,19,0,42,47,20,42,25,67
"2007/11/8",4,37,0,58,72,27,58,41,99
"2007/11/9",7,28,0,56,66,25,54,37,91
"2007/12/1",4,32,1,76,55,58,73,40,113
"2007/12/10",7,24,0,58,65,24,56,33,89
"2007/12/11",6,15,0,65,61,25,55,31,86
"2007/12/12",7,23,0,41,57,14,51,20,71
"2007/12/13",5,28,1,46,58,22,53,27,80
"2007/12/14",6,34,0,54,49,45,57,37,94
"2007/12/15",9,30,1,91,59,72,108,23,131
"2007/12/16",4,39,0,60,50,53,53,50,103
"2007/12/17",8,34,0,54,74,22,52,44,96
"2007/12/18",0,24,0,40,49,15,37,27,64
"2007/12/19",2,36,1,52,71,20,64,27,91
"2007/12/2",12,45,1,81,50,89,100,39,139
"2007/12/20",1,32,0,56,57,32,58,31,89
"2007/12/21",9,42,0,77,60,68,91,37,128
"2007/12/22",9,31,0,81,47,74,92,29,121
"2007/12/23",4,28,1,56,43,46,56,33,89
"2007/12/24",5,23,0,45,39,34,39,34,73
"2007/12/25",5,32,0,51,38,50,40,48,88
"2007/12/26",11,27,0,48,33,53,44,42,86
"2007/12/27",4,29,0,52,61,24,48,37,85
"2007/12/28",3,27,0,45,43,32,43,32,75
"2007/12/29",7,36,1,49,49,44,53,40,93
"2007/12/3",6,30,0,45,55,26,40,41,81
"2007/12/30",4,53,0,69,76,50,67,59,126
"2007/12/31",4,29,0,62,48,47,70,25,95
"2007/12/4",4,37,1,55,74,23,55,42,97
"2007/12/5",2,21,0,48,46,25,41,30,71
"2007/12/6",7,23,0,53,53,30,65,18,83
"2007/12/7",5,33,0,64,61,41,58,44,102
"2007/12/8",8,41,5,101,86,69,108,47,155
"2007/12/9",3,45,0,85,61,72,82,51,133
"2007/2/1",3,20,0,47,50,20,41,29,70
"2007/2/10",9,36,0,68,62,51,73,40,113
"2007/2/11",10,33,0,63,57,49,59,47,106
"2007/2/12",4,20,0,42,52,14,36,30,66
"2007/2/13",1,24,0,54,53,26,40,39,79
"2007/2/14",6,30,1,48,63,22,60,25,85
"2007/2/15",7,35,0,70,73,39,69,43,112
"2007/2/16",8,25,0,52,54,31,53,32,85
"2007/2/17",9,37,0,74,53,67,77,43,120
"2007/2/18",15,45,0,76,74,62,66,70,136
"2007/2/19",1,27,0,53,55,26,41,40,81
"2007/2/2",9,35,0,58,59,43,75,27,102
"2007/2/20",2,40,0,45,69,18,47,40,87
"2007/2/21",1,31,1,63,75,21,55,41,96
"2007/2/22",4,36,0,41,60,21,48,33,81
"2007/2/23",3,30,0,82,76,39,83,32,115
"2007/2/24",10,26,0,73,53,56,80,29,109
"2007/2/25",1,31,0,78,51,59,67,43,110
"2007/2/26",4,20,0,48,49,23,42,30,72
"2007/2/27",12,28,0,40,59,21,46,34,80
"2007/2/28",8,30,0,58,65,31,60,36,96
"2007/2/3",11,38,0,63,50,62,67,45,112
"2007/2/4",11,44,0,96,79,72,86,65,151
"2007/2/5",6,26,0,59,68,23,49,42,91
"2007/2/6",5,32,1,62,73,27,60,40,100
"2007/2/7",6,20,0,46,55,17,45,27,72
"2007/2/8",3,25,0,57,57,28,54,31,85
"2007/2/9",7,35,1,86,82,47,85,44,129
"2007/3/1",11,27,0,50,60,28,46,42,88
"2007/3/10",11,33,0,78,54,68,85,37,122
"2007/3/11",19,40,0,71,60,70,78,52,130
"2007/3/12",7,23,0,45,58,17,42,33,75
"2007/3/13",5,20,1,43,55,14,52,17,69
"2007/3/14",7,24,0,57,71,17,55,33,88
"2007/3/15",6,22,0,51,60,19,55,24,79
"2007/3/16",11,39,0,67,78,39,77,40,117
"2007/3/17",8,38,0,79,56,69,88,37,125
"2007/3/18",7,57,0,87,86,65,92,59,151
"2007/3/19",9,37,0,59,79,26,55,50,105
"2007/3/2",6,44,0,66,71,45,87,29,116
"2007/3/20",4,23,0,63,69,21,55,35,90
"2007/3/21",3,38,0,70,79,32,65,46,111
"2007/3/22",6,35,0,49,55,35,61,29,90
"2007/3/23",5,44,0,71,69,51,74,46,120
"2007/3/24",6,57,0,76,57,82,82,57,139
"2007/3/25",4,39,0,61,60,44,57,47,104
"2007/3/26",6,23,0,54,62,21,57,26,83
"2007/3/27",4,26,0,50,62,18,48,32,80
"2007/3/28",0,27,0,62,66,23,59,30,89
"2007/3/29",6,23,0,48,57,20,48,29,77
"2007/3/3",8,38,0,78,46,78,87,37,124
"2007/3/30",8,22,0,81,67,44,77,34,111
"2007/3/31",5,31,0,81,51,66,86,31,117
"2007/3/4",4,55,2,106,74,93,111,56,167
"2007/3/5",6,34,0,50,69,21,47,43,90
"2007/3/6",3,19,0,50,50,22,40,32,72
"2007/3/7",2,25,0,53,53,27,49,31,80
"2007/3/8",6,35,1,69,76,35,70,41,111
"2007/3/9",0,27,0,57,53,31,59,25,84
"2007/4/1",4,40,0,74,53,65,75,43,118
"2007/4/10",3,17,0,46,51,15,42,24,66
"2007/4/11",2,18,0,51,55,16,46,25,71
"2007/4/12",4,20,0,43,41,26,40,27,67
"2007/4/13",6,25,0,50,51,30,58,23,81
"2007/4/14",5,42,1,79,56,71,88,39,127
"2007/4/15",5,42,0,57,43,61,66,38,104
"2007/4/16",5,19,0,42,45,21,48,18,66
"2007/4/17",3,22,0,47,53,19,44,28,72
"2007/4/18",3,25,0,51,61,18,44,35,79
"2007/4/19",5,26,0,62,73,20,60,33,93
"2007/4/2",9,22,0,56,62,25,51,36,87
"2007/4/20",4,20,0,46,39,31,57,13,70
"2007/4/21",11,27,0,64,47,55,71,31,102
"2007/4/22",5,31,0,67,50,53,63,40,103
"2007/4/23",2,21,0,39,42,20,27,35,62
"2007/4/24",2,12,0,46,48,12,39,21,60
"2007/4/25",10,44,1,73,51,77,72,56,128
"2007/4/26",9,25,0,55,59,30,52,37,89
"2007/4/27",6,22,0,53,49,32,50,31,81
"2007/4/28",6,27,0,65,49,49,56,42,98
"2007/4/29",12,54,0,59,59,66,72,53,125
"2007/4/3",9,19,0,46,56,18,43,31,74
"2007/4/30",3,23,0,39,51,14,44,21,65
"2007/4/4",13,36,0,41,70,20,57,33,90
"2007/4/5",3,31,0,60,64,30,72,22,94
"2007/4/6",14,34,0,68,62,54,80,36,116
"2007/4/7",6,30,1,56,50,43,56,37,93
"2007/4/8",6,41,0,68,58,57,68,47,115
"2007/4/9",10,38,0,65,65,48,66,47,113
"2007/5/1",2,7,0,44,43,10,39,14,53
"2007/5/10",2,25,0,32,37,22,37,22,59
"2007/5/11",9,31,0,57,60,37,67,30,97
"2007/5/12",9,29,0,74,62,50,80,32,112
"2007/5/13",5,32,0,73,52,58,67,43,110
"2007/5/14",5,17,0,66,67,21,61,27,88
"2007/5/15",3,39,0,49,70,21,51,40,91
"2007/5/16",3,22,0,31,45,11,33,23,56
"2007/5/17",6,19,0,63,60,28,53,35,88
"2007/5/18",6,24,0,51,43,38,55,26,81
"2007/5/19",9,39,0,84,70,62,92,40,132
"2007/5/2",9,23,0,41,53,20,41,32,73
"2007/5/20",7,33,1,69,59,51,61,49,110
"2007/5/21",12,26,0,52,65,25,43,47,90
"2007/5/22",3,22,0,41,49,17,43,23,66
"2007/5/23",6,13,0,46,39,26,38,27,65
"2007/5/24",8,23,0,57,60,28,58,30,88
"2007/5/25",6,21,0,63,62,28,60,30,90
"2007/5/26",8,36,0,53,43,54,63,34,97
"2007/5/27",7,34,0,73,51,63,73,41,114
"2007/5/28",4,18,0,57,64,15,49,30,79
"2007/5/29",6,20,0,40,55,11,36,30,66
"2007/5/3",5,30,0,60,70,25,62,33,95
"2007/5/30",9,25,1,50,57,28,57,28,85
"2007/5/31",6,28,0,42,53,23,43,33,76
"2007/5/4",6,32,0,60,61,37,65,33,98
"2007/5/5",6,36,1,96,68,71,98,41,139
"2007/5/6",10,35,0,95,72,68,102,38,140
"2007/5/7",1,29,0,37,55,12,33,34,67
"2007/5/8",4,27,0,43,61,13,42,32,74
"2007/5/9",1,27,0,42,52,18,41,29,70
"2007/6/1",3,32,0,54,64,25,63,26,89
"2007/6/10",6,46,0,76,50,78,81,47,128
"2007/6/11",6,32,0,57,61,34,53,42,95
"2007/6/12",9,34,0,36,62,17,40,39,79
"2007/6/13",5,15,0,36,39,17,31,25,56
"2007/6/14",3,15,0,56,50,24,45,29,74
"2007/6/15",3,20,0,47,33,37,49,21,70
"2007/6/16",12,24,0,72,52,56,72,36,108
"2007/6/17",9,29,0,66,44,60,75,29,104
"2007/6/18",4,35,0,45,58,26,44,40,84
"2007/6/19",1,17,0,32,43,7,28,22,50
"2007/6/2",15,40,0,60,50,65,82,33,115
"2007/6/20",3,25,0,32,44,16,39,21,60
"2007/6/21",7,19,0,36,43,19,38,24,62
"2007/6/22",11,27,0,55,60,33,56,37,93
"2007/6/23",8,23,0,59,39,51,57,33,90
"2007/6/24",6,30,0,63,48,51,66,33,99
"2007/6/25",4,19,0,41,54,10,36,28,64
"2007/6/26",3,17,0,43,49,14,41,22,63
"2007/6/27",0,23,0,30,39,14,31,22,53
"2007/6/28",1,20,0,45,48,18,40,26,66
"2007/6/29",2,23,0,67,59,33,57,35,92
"2007/6/3",7,44,0,68,53,66,77,42,119
"2007/6/30",6,35,1,71,52,61,70,43,113
"2007/6/4",7,20,0,48,56,19,46,29,75
"2007/6/5",6,22,0,38,49,17,46,20,66
"2007/6/6",3,22,0,40,54,11,36,29,65
"2007/6/7",3,27,0,50,51,29,44,36,80
"2007/6/8",1,28,0,41,44,26,46,24,70
"2007/6/9",9,31,1,66,45,62,76,31,107
"2007/7/1",10,38,0,71,53,66,75,44,119
"2007/7/10",0,16,0,44,48,12,40,20,60
"2007/7/11",4,22,0,46,56,16,37,35,72
"2007/7/12",5,23,0,37,46,19,40,25,65
"2007/7/13",4,18,1,55,42,36,56,22,78
"2007/7/14",9,24,0,73,52,54,71,35,106
"2007/7/15",6,35,0,64,46,59,73,32,105
"2007/7/16",4,17,0,32,41,12,29,24,53
"2007/7/17",5,17,1,41,54,10,39,25,64
"2007/7/18",1,19,0,44,49,15,35,29,64
"2007/7/19",6,31,0,44,60,21,56,25,81
"2007/7/2",3,21,1,50,51,24,47,28,75
"2007/7/20",4,20,0,53,47,30,53,24,77
"2007/7/21",5,36,1,73,43,72,86,29,115
"2007/7/22",10,23,9,65,57,50,74,33,107
"2007/7/23",5,18,3,51,66,11,41,36,77
"2007/7/24",4,18,1,38,41,20,36,25,61
"2007/7/25",5,23,2,52,63,19,58,24,82
"2007/7/26",5,17,1,54,59,18,54,23,77
"2007/7/27",8,30,0,62,64,36,60,40,100
"2007/7/28",9,34,1,76,56,64,84,36,120
"2007/7/29",10,31,6,78,65,60,79,46,125
"2007/7/3",8,10,3,44,44,21,46,19,65
"2007/7/30",6,17,3,51,58,19,47,30,77
"2007/7/31",11,21,0,41,59,14,40,33,73
"2007/7/4",2,19,0,47,44,24,48,20,68
"2007/7/5",4,29,1,34,43,25,40,28,68
"2007/7/6",3,26,0,57,50,36,56,30,86
"2007/7/7",13,30,0,60,43,60,71,32,103
"2007/7/8",6,31,0,57,45,49,62,32,94
"2007/7/9",4,16,0,33,43,10,31,22,53
"2007/8/1",4,31,0,43,49,29,54,24,78
"2007/8/10",5,28,1,43,46,31,51,26,77
"2007/8/11",6,41,2,81,62,68,84,46,130
"2007/8/12",3,35,3,69,53,57,72,38,110
"2007/8/13",10,13,0,46,56,13,41,28,69
"2007/8/14",4,25,0,47,66,10,35,41,76
"2007/8/15",12,26,0,41,64,15,51,28,79
"2007/8/16",3,36,0,46,63,22,55,30,85
"2007/8/17",5,35,0,64,60,44,73,31,104
"2007/8/18",8,54,0,88,66,84,105,45,150
"2007/8/19",6,24,0,63,38,55,60,33,93
"2007/8/2",2,33,0,72,80,27,77,30,107
"2007/8/20",4,14,1,46,51,14,36,29,65
"2007/8/21",3,29,0,46,60,18,43,35,78
"2007/8/22",2,20,0,55,66,11,47,30,77
"2007/8/23",4,33,1,46,60,24,57,27,84
"2007/8/24",7,29,0,53,52,37,58,31,89
"2007/8/25",4,30,0,55,44,45,61,28,89
"2007/8/26",6,31,0,74,45,66,79,32,111
"2007/8/27",6,17,0,62,63,22,64,21,85
"2007/8/28",12,23,1,49,65,20,57,28,85
"2007/8/29",3,25,0,36,45,19,40,24,64
"2007/8/3",6,16,0,39,38,23,42,19,61
"2007/8/30",4,14,0,50,48,20,45,23,68
"2007/8/31",0,29,0,64,67,26,67,26,93
"2007/8/4",9,36,0,78,62,61,86,37,123
"2007/8/5",11,32,0,81,54,70,75,49,124
"2007/8/6",3,31,0,50,66,18,49,35,84
"2007/8/7",5,21,1,48,49,26,55,20,75
"2007/8/8",4,28,0,37,52,17,46,23,69
"2007/8/9",14,18,0,59,64,27,57,34,91
"2007/9/1",6,29,0,94,60,69,91,38,129
"2007/9/10",1,35,0,56,66,26,56,36,92
"2007/9/11",6,18,0,47,59,12,50,21,71
"2007/9/12",8,26,0,46,63,17,48,32,80
"2007/9/13",7,24,0,47,49,29,43,35,78
"2007/9/14",9,19,0,50,45,33,56,22,78
"2007/9/15",4,21,0,67,52,40,70,22,92
"2007/9/16",13,34,0,86,62,71,90,43,133
"2007/9/17",8,19,0,38,49,16,42,23,65
"2007/9/18",4,26,0,45,62,13,42,33,75
"2007/9/19",6,18,0,43,44,23,49,18,67
"2007/9/2",14,48,0,66,60,68,80,48,128
"2007/9/20",11,20,0,37,47,21,47,21,68
"2007/9/21",9,35,0,69,80,33,84,29,113
"2007/9/22",1,38,0,81,58,62,83,37,120
"2007/9/23",8,34,0,79,46,75,82,39,121
"2007/9/24",3,19,0,42,51,13,43,21,64
"2007/9/25",4,22,1,49,59,17,53,23,76
"2007/9/26",4,19,1,53,61,16,53,24,77
"2007/9/27",4,26,0,62,71,21,62,30,92
"2007/9/28",4,38,0,61,67,36,64,39,103
"2007/9/29",10,31,0,72,60,53,79,34,113
"2007/9/3",3,19,0,57,61,18,47,32,79
"2007/9/30",15,41,0,90,65,81,94,52,146
"2007/9/4",3,16,1,45,52,13,42,23,65
"2007/9/5",7,12,0,36,38,17,34,21,55
"2007/9/6",3,29,0,51,58,25,52,31,83
"2007/9/7",9,31,1,58,40,59,65,34,99
"2007/9/8",13,33,0,43,40,49,53,36,89
"2008/1/1",13,49,1,97,40,120,103,57,160
"2008/1/10",8,29,0,34,43,28,47,24,71
"2008/1/11",4,25,0,52,57,24,59,22,81
"2008/1/12",9,31,0,58,36,62,69,29,98
"2008/1/13",7,37,0,71,51,64,78,37,115
"2008/1/14",4,19,0,38,47,14,35,26,61
"2008/1/15",5,16,0,58,54,25,54,25,79
"2008/1/16",6,23,0,56,60,25,49,36,85
"2008/1/17",7,29,0,37,43,30,43,30,73
"2008/1/18",3,15,0,52,41,29,52,18,70
"2008/1/19",4,36,1,80,59,62,70,51,121
"2008/1/2",2,29,1,60,69,23,47,45,92
"2008/1/20",4,33,0,78,52,63,75,40,115
"2008/1/21",2,19,0,43,43,21,35,29,64
"2008/1/22",7,12,0,40,44,15,33,26,59
"2008/1/23",4,21,0,59,60,24,48,36,84
"2008/1/24",7,23,0,48,56,22,45,33,78
"2008/1/25",8,30,0,48,49,37,55,31,86
"2008/1/26",10,49,1,96,59,97,109,47,156
"2008/1/27",7,35,1,80,62,61,88,35,123
"2008/1/28",7,32,1,47,49,38,54,33,87
"2008/1/29",3,27,0,53,64,19,53,30,83
"2008/1/3",1,28,0,48,52,25,46,31,77
"2008/1/30",7,24,0,50,53,28,52,29,81
"2008/1/31",6,36,0,50,59,33,58,34,92
"2008/1/4",7,26,0,62,65,30,66,29,95
"2008/1/5",13,29,0,58,55,45,58,42,100
"2008/1/6",11,44,0,65,56,64,61,59,120
"2008/1/7",7,19,0,57,58,25,45,38,83
"2008/1/8",17,34,0,35,60,26,37,49,86
"2008/1/9",7,25,0,37,48,21,39,30,69
"2008/10/1",1,23,0,43,51,16,44,23,67
"2008/10/10",4,14,8,63,50,39,57,32,89
"2008/10/11",3,47,0,80,58,72,88,42,130
"2008/10/12",4,42,1,68,53,62,69,46,115
"2008/10/13",7,19,0,44,45,25,51,19,70
"2008/10/14",2,17,1,40,47,13,40,20,60
"2008/10/15",8,25,1,50,55,29,51,33,84
"2008/10/16",7,18,1,59,61,24,57,28,85
"2008/10/17",6,47,0,71,75,49,91,33,124
"2008/10/18",7,67,2,74,74,76,93,57,150
"2008/10/19",9,59,0,83,68,83,101,50,151
"2008/10/2",2,31,0,72,73,32,73,32,105
"2008/10/20",4,21,0,44,53,16,38,31,69
"2008/10/21",3,29,0,47,59,20,50,29,79
"2008/10/22",3,25,0,34,48,14,33,29,62
"2008/10/23",4,23,0,41,51,17,50,18,68
"2008/10/24",3,44,0,60,64,43,74,33,107
"2008/10/25",8,31,0,81,57,63,85,35,120
"2008/10/26",12,31,0,79,55,67,87,35,122
"2008/10/27",5,28,0,58,55,36,53,38,91
"2008/10/28",7,36,0,54,77,20,52,45,97
"2008/10/29",10,24,0,40,55,19,44,30,74
"2008/10/3",5,33,0,65,57,46,63,40,103
"2008/10/30",11,21,0,65,73,24,61,36,97
"2008/10/31",5,35,0,97,87,50,97,40,137
"2008/10/4",5,32,0,71,46,62,80,28,108
"2008/10/5",7,30,0,70,49,58,78,29,107
"2008/10/6",2,18,0,47,38,29,46,21,67
